[
----------------------------------|
-           ===                + -|
-                              + -|
-          +       +        ------|
-                           =====-|
-     ***        *****           -|
------------------------         -|
-+               =            +  -|
-             +     +            -|
-                          -     -|
-*   *      *         *     *****-|
--------   -----------------------|
-=                               -|
-                              + -|
-                  ---       -----|
-  +                             -|
-*      ***             **       -|
-------------------   -------    -|
-                =         =     -|
-              +                 -|
-       -                        -|
-** + **-    *             *     -|
----------------------------------|
]
/