[
----------------------------------|
-                                -|
-                              + -|
-                         --------|
-                         ==     -|
-------             **           -|
-   =            --------      + -|
-                                -|
-   *     *                      -|
-   ----------                   -|
-                           -    -|
-   +                            -|
-                 +             --|
-               -------          -|
-                 ==             -|
-      --                        -|
-                         --------|
-                                -|
- *    +    *                 +  -|
----------------------------------|
]
/