[
--------------------------------------------------------------------|
-                                                   ==             -|
-           +                                                    + -|
-                                               -             ------|
-                                               -                  -|
-          **                             **    -        **      + -|
-------------------------------  -----------------------------------|
-                           = -  -                                 -|
-           +                 -  -                   +             -|
-                           + -  -          ------------------------|
-                             -  -       ---===                    -|
-         ------       -      -  -      =                          -|
-                      -    * -  ---           +                   -|
-                      --------  -                                 -|
-----                         -  -                **               -|
-                             -  -----------------------           -|
-                             -  -                ======-          -|
-   *  + *        -----       -  -                       -         -|
-    ------                                    +                   -|
-                                                                  -|
-                                       ****                       -|
--------------------------------------------------------------------|
]
/